210000000000010000000001000000000000000000000001000
010111111111010111110101111101111111111111111101010
010001010000010100000100000001000100000000010101010
011101010111111101111111111111011101111101010101010
000001010000000101000001000100000001000001000101010
111111011111110101011101010111011111011111110101110
000000010000000100000100010001000100010001000100010
011111110111111111111111111101111101110111011111010
000000000100010000000100000001000001000100010000010
011111111101010101110101111111011111011101110111110
000000010001010101000101000100010000010000010100010
111111011101010101011101011101011111010111110101010
010001000001010101000001010001010001000101000101000
010101111111011101111111010111010101011101011101110
000100000001000101000000000101000101000001010001010
011111110111110101011111111101111101111101010111010
010000010100010101000000000100010001000101010001010
010111010101010101111111110111010111010111011101010
000100010001000001000000000000010000010000000001003